CitationManagerCustomRange	false
CitationManagerStartIndex	1
citman_count	200
citman_start	1
coll_start	1
CollectionStartIndex	1
email_add_text	
email_address	
email_format	docsum
email_start	1
email_subj	((China)+AND+(microRNA+OR+miRNA+OR+circRNA+OR+"non+-+PubMed
EmailCheck1	
EmailCheck2	
EntrezSystem2.PEntrez.DbConnector.Cmd	displaychanged
EntrezSystem2.PEntrez.DbConnector.Db	pubmed
EntrezSystem2.PEntrez.DbConnector.IdsFromResult	
EntrezSystem2.PEntrez.DbConnector.LastDb	pubmed
EntrezSystem2.PEntrez.DbConnector.LastIdsFromResult	
EntrezSystem2.PEntrez.DbConnector.LastQueryKey	4
EntrezSystem2.PEntrez.DbConnector.LastTabCmd	
EntrezSystem2.PEntrez.DbConnector.LinkName	
EntrezSystem2.PEntrez.DbConnector.LinkReadableName	
EntrezSystem2.PEntrez.DbConnector.LinkSrcDb	
EntrezSystem2.PEntrez.DbConnector.QueryKey	
EntrezSystem2.PEntrez.DbConnector.TabCmd	
EntrezSystem2.PEntrez.DbConnector.Term	((China)+AND+(microRNA+OR+miRNA+OR+circRNA+OR+"noncoding+RNA"+OR+"non-coding+RNA"))+AND+("2010"[Date+-+Publication]+:+"2019"[Date+-+Publication])
EntrezSystem2.PEntrez.PubMed.Pubmed_Facets.BMFacets	
EntrezSystem2.PEntrez.PubMed.Pubmed_Facets.FacetSubmitted	false
EntrezSystem2.PEntrez.PubMed.Pubmed_Facets.FacetsUrlFrag	filters=
EntrezSystem2.PEntrez.PubMed.Pubmed_PageController.PreviousPageName	results
EntrezSystem2.PEntrez.PubMed.Pubmed_PageController.SpecialPageName	
EntrezSystem2.PEntrez.PubMed.Pubmed_ResultsPanel.EmailTab.Answer	
EntrezSystem2.PEntrez.PubMed.Pubmed_ResultsPanel.EmailTab.Email	
EntrezSystem2.PEntrez.PubMed.Pubmed_ResultsPanel.EmailTab.EmailCount	
EntrezSystem2.PEntrez.PubMed.Pubmed_ResultsPanel.EmailTab.EmailFormat	
EntrezSystem2.PEntrez.PubMed.Pubmed_ResultsPanel.EmailTab.EmailHID	1-AZ3KKdHGWQT9mqMUTW56mMtoigfyezswc3ctrsitxXtbwxfh8MkXOdu7gKf8dX7h99gxdjc-vzk6m0qdviwzpADWT5sivQv
EntrezSystem2.PEntrez.PubMed.Pubmed_ResultsPanel.EmailTab.EmailQueryKey	
EntrezSystem2.PEntrez.PubMed.Pubmed_ResultsPanel.EmailTab.EmailReport	
EntrezSystem2.PEntrez.PubMed.Pubmed_ResultsPanel.EmailTab.EmailSort	
EntrezSystem2.PEntrez.PubMed.Pubmed_ResultsPanel.EmailTab.EmailStart	
EntrezSystem2.PEntrez.PubMed.Pubmed_ResultsPanel.EmailTab.EmailSubject	
EntrezSystem2.PEntrez.PubMed.Pubmed_ResultsPanel.EmailTab.EmailText	
EntrezSystem2.PEntrez.PubMed.Pubmed_ResultsPanel.EmailTab.Holding	
EntrezSystem2.PEntrez.PubMed.Pubmed_ResultsPanel.EmailTab.HoldingFft	
EntrezSystem2.PEntrez.PubMed.Pubmed_ResultsPanel.EmailTab.HoldingNdiSet	
EntrezSystem2.PEntrez.PubMed.Pubmed_ResultsPanel.EmailTab.Key	
EntrezSystem2.PEntrez.PubMed.Pubmed_ResultsPanel.EmailTab.OToolValue	
EntrezSystem2.PEntrez.PubMed.Pubmed_ResultsPanel.EmailTab.QueryDescription	
EntrezSystem2.PEntrez.PubMed.Pubmed_ResultsPanel.EmailTab.SubjectList	
EntrezSystem2.PEntrez.PubMed.Pubmed_ResultsPanel.Pubmed_DisplayBar.email_count	200
EntrezSystem2.PEntrez.PubMed.Pubmed_ResultsPanel.Pubmed_DisplayBar.email_sort	
EntrezSystem2.PEntrez.PubMed.Pubmed_ResultsPanel.Pubmed_DisplayBar.FFormat	docsum
EntrezSystem2.PEntrez.PubMed.Pubmed_ResultsPanel.Pubmed_DisplayBar.FileFormat	docsum
EntrezSystem2.PEntrez.PubMed.Pubmed_ResultsPanel.Pubmed_DisplayBar.FileSort	
EntrezSystem2.PEntrez.PubMed.Pubmed_ResultsPanel.Pubmed_DisplayBar.Format	text
EntrezSystem2.PEntrez.PubMed.Pubmed_ResultsPanel.Pubmed_DisplayBar.FSort	
EntrezSystem2.PEntrez.PubMed.Pubmed_ResultsPanel.Pubmed_DisplayBar.LastFormat	
EntrezSystem2.PEntrez.PubMed.Pubmed_ResultsPanel.Pubmed_DisplayBar.LastPageSize	200
EntrezSystem2.PEntrez.PubMed.Pubmed_ResultsPanel.Pubmed_DisplayBar.LastPresentation	docsum
EntrezSystem2.PEntrez.PubMed.Pubmed_ResultsPanel.Pubmed_DisplayBar.LastSort	
EntrezSystem2.PEntrez.PubMed.Pubmed_ResultsPanel.Pubmed_DisplayBar.PageSize	200
EntrezSystem2.PEntrez.PubMed.Pubmed_ResultsPanel.Pubmed_DisplayBar.Presentation	uilist
EntrezSystem2.PEntrez.PubMed.Pubmed_ResultsPanel.Pubmed_DisplayBar.PrevPageSize	200
EntrezSystem2.PEntrez.PubMed.Pubmed_ResultsPanel.Pubmed_DisplayBar.PrevPresentation	docsum
EntrezSystem2.PEntrez.PubMed.Pubmed_ResultsPanel.Pubmed_DisplayBar.PrevSort	
EntrezSystem2.PEntrez.PubMed.Pubmed_ResultsPanel.Pubmed_DisplayBar.Sort	
EntrezSystem2.PEntrez.PubMed.Pubmed_ResultsPanel.Pubmed_DisplayBar.sPageSize	200
EntrezSystem2.PEntrez.PubMed.Pubmed_ResultsPanel.Pubmed_DisplayBar.sPresentation	uilist
EntrezSystem2.PEntrez.PubMed.Pubmed_ResultsPanel.Pubmed_DisplayBar.sSort	none
EntrezSystem2.PEntrez.PubMed.Pubmed_ResultsPanel.Pubmed_Pager.cPage	[â€¦]
EntrezSystem2.PEntrez.PubMed.Pubmed_ResultsPanel.Pubmed_Pager.CurrPage	1
EntrezSystem2.PEntrez.PubMed.Pubmed_ResultsPanel.Pubmed_ResultsController.ResultCount	34955
EntrezSystem2.PEntrez.PubMed.Pubmed_ResultsPanel.Pubmed_ResultsController.RunLastQuery	
EntrezSystem2.PEntrez.PubMed.Pubmed_ResultsPanel.TimelineAdPlaceHolder.BlobID	NCID_1_89902867_130.14.22.215_9001_1539830327_1969173407_0MetA0_S_MegaStore_F_1
EntrezSystem2.PEntrez.PubMed.Pubmed_ResultsPanel.TimelineAdPlaceHolder.CurrTimelineYear	
p$a	EntrezSystem2.PEntrez.PubMed.Pubmed_ResultsPanel.Pubmed_DisplayBar.sPresentation
p$l	EntrezSystem2
p$st	pubmed
term	((China)+AND+(microRNA+OR+miRNA+OR+circRNA+OR+"noncoding+RNA"+OR+"non-coding+RNA"))+AND+("2010"[Date+-+Publication]+:+"2019"[Date+-+Publication])+